433333333333333333333333333335
211111111111111111111111111112
211111111111111111111111111112
211111111111111111111111111112
211110000000000000000000011112
211110000000000000000000011112
211110000000000000000000011112
211110000000000000000000011112
211110000000000000000000011112
211110000000000000000000011112
211110000000000000000000011112
211110000000000000000000011112
211110000000000000000000011112
211110000000000000000000011112
211110000000000000000000011112
211110000000000000000000011112
211110000000000000000000011112
211110000000000000000000011112
211110000000000000000000011112
211110000000000000000000011112
211110000000000000000000011112
211110000000000000000000011112
211110000000000000000000011112
211110000000000000000000011112
211110000000000000000000011112
211110000000000000000000011112
211110000000000000000000011112
211110000000000000000000011112
211110000000000000000000011112
211111111111111111111111111112
211111111111111111111111111112
211111111111111111111111111112
633333333333333333333333333337