033333333333333333333333333330
211111111111111111111111111114
211111111111111111111111111114
211111111111111111111111111114
211110000000000000000000011114
211110000000000000000000011114
211110000000000000000000011114
211110000000000000000000011114
211110000000000000000000011114
211110000000000000000000011114
211110000000000000000000011114
211110000000000000000000011114
211110000000000000000000011114
211110000000000000000000011114
211110000000000000000000011114
211110000000000000000000011114
211110000000000000000000011114
211110000000000000000000011114
211110000000000000000000011114
211110000000000000000000011114
211110000000000000000000011114
211110000000000000000000011114
211110000000000000000000011114
211110000000000000000000011114
211110000000000000000000011114
211110000000000000000000011114
211111111111111111111111111114
211111111111111111111111111114
211111111111111111111111111114
055555555555555555555555555550